0000000000000000000000000000000000000000
0000000000000000000000000000000000000000
0000000000000000000000000000000000000000
0001111111111111111111111111111111111000
0001211111111111111111111111111111111000
0001211100011111111111111111111111111000
0001111100011111111111111111111111111000
0001111100011111111111111111111111111000
0001111110000011111111111111111111111000
0001111111000001111111111111111111111000
0001111111100011111111111111111111111000
0001111111111111111111111111111111111000
0001111111111111111111111111111111111000
0001111111111111111111111111111111111000
0001111111111111111111111111111111111000
0001111111111111111111111111111111111000
0000111111111001111111111111111111111000
0000000111000011111111111111111111111000
0000000000000011111111111111111111111000
0000000000001111111111111111111111111000
0000111111111111111100111111111111111000
0001111111111111111000011111111111111000
0001111111111111111000011111111111111000
0001111111111111111100001111111111111000
0001111111111111111111000111111111111000
0001111111111111111111100111111111111000
0001111111111111111111101111111111111000
0001111111111111111111111111111111111000
0001111111111111111111111111111111111000
0001111111111111111111111111111111111000
0001111111111111111111111111111111111000
0001111111111111111111111111111111111000
0001111111111111111111111111111111111000
0001111111111111111111111111111111111000
0001111111111111111111111111111111111000
0001111111111111111111111111111111111000
0001111111111111111111111111111111111000
0000000000000000000000000000000000000000
0000000000000000000000000000000000000000
0000000000000000000000000000000000000000